....................
....................
OOOOOO........OOOOOO
....................
....................
.......OOOOOO.......
....................
....................
OOOOOO........OOOOOO
....................
....................
OOOOOOOOOOOOOOOOOOOO