....................
....................
....................
....................
....................
.......LOOOOR.......
....................
....................
OOOOOR........LOOOOO
....................
....................
OOOOOOOOOOOOOOOOOOOO