....................
....................
...OOOO......OOOO...
....................
........OOOO........
OO................OO
....................
....OOOO....OOOO....
....................
...O.....OO.....O...
...O.....OO.....O...
OOOOOOOOOOOOOOOOOOOO