....................
....................
....................
....................
........LOOR........
OR................LO
....................
....LOOO....OOOR....
....................
...O.....OO.....O...
...O.....OO.....O...
OOOOOOOOOOOOOOOOOOOO