....................
....................
..OOOOO......OOOOO..
....................
....................
........OOOO........
....................
....................
..OOOOO......OOOOO..
....................
.........OO.........
OOOOOOOOOOOOOOOOOOOO