....................
....................
....................
....................
....................
........LOOR........
....................
....................
..LOOOR......LOOOR..
....................
.........OO.........
OOOOOOOOOOOOOOOOOOOO