....................
....................
...OOOO......OOOO...
....................
OO......OOOO......OO
....................
....................
.....OOO....OOO.....
....................
...O.....OO.....O...
...O.....OO.....O...
OOOOOOOOOOOOOOOOOOOO